0 0 0 0 0 2 2 2 0 0 0 0 4 4 0 4  
0 4 0 0 2 2 0 0 0 0 4 0 0 6 6 6  
0 4 0 0 0 2 2 0 0 0 4 0 0 2 2 6  
0 0 0 0 0 0 2 2 0 0 0 0 2 2 6 6  
0 0 0 4 0 0 0 3 3 0 0 4 6 6 6 1  
0 0 4 4 0 0 0 0 2 2 0 4 4 0 0 1  
0 0 0 4 0 0 0 0 0 2 2 0 4 0 0 1  
0 0 0 0 0 0 0 0 0 0 2 2 0 0 0 1  
0 0 0 0 4 4 0 0 0 0 0 2 2 0 0 1  
0 0 0 0 4 0 0 0 0 0 0 0 2 2 0 1  
5 5 0 0 0 0 0 0 0 0 0 0 0 2 2 1  
5 5 0 0 0 0 0 0 0 0 0 0 0 2 2 1  